0 0 1 G P 0 e 0 p 0 1
1 0 p 0 1 E 1 0 1 0 1
1 0 1 0 1 0 1 0 0 K p
0 0 P 0 p 0 0 0 1 0 0
0 1 1 0 K C 1 0 1 P 1
0 0 0 0 1 0 p 0 0 0 e
K 1 e E E 1 e 1 P E 1