+-+-+-+-+-+-+-+
|b|   | | |   |
+ +-+ + + +-+ +
|   |   |     |
+ + + +-+ +-+ +
| |   |     | |
+ +-+-+ +-+-+ +
|       |     |
+-+ + +-+-+ +-+
|            c|
+-+-+-+-+-+-+-+
