1 1 1 1 1 1 1 1 1 1 1 1 1
1 G 0 0 0 0 0 0 0 0 0 p 1
1 0 1 1 1 K K K 1 1 1 0 1
1 0 1 1 1 K K K 1 1 1 0 1
1 E 0 0 0 0 0 0 0 0 C K 1
1 1 1 1 1 1 1 1 1 1 1 1 1